Sprites/Backgrounds/levelDesign.jpg
11111111111111111111111111111111111111111111111111111111111111111111111111111111
1                                                                              1
1                                                                              1
x                                                                              1
x                                                                              1
x                                                                              1
x                                                                              1
x                                                                              1
x                                                                              1
x                                                                              1
x                                                                              1
x          11                                                             4    1
x    P                        1     1                                     4    1
x            b        111     x22222x                                     4    1
1111111111111111111111xxx1    xxxxxxx111111111111111   1111111111111111111111111
                         333333                    333333                       